586,586,586,586,586,586,586,586,586,586
586,16,16,16,16,16,16,485,485,586
586,16,200,16,16,16,16,194,0,586
586,16,16,16,16,16,16,485,485,586
586,586,586,326,586,586,586,586,586,586
586,16,16,16,16,16,16,16,16,586
586,16,16,16,16,16,960,754,16,586
586,16,16,16,16,16,16,16,16,586
586,16,16,16,16,16,16,16,16,586
586,4,4,4,25,4,4,4,4,586
586,586,586,586,586,586,586,586,586,586
