0,25,0,991,983,1011,1018,0
0,4,0,0,0,0,0,0
0,4,4,921,1013,990,979,1022
0,4,0,0,0,0,0,0
0,4,4,922,990,1012,979,982
